H,H,H,H,H,H,H,H,H,H,H,H,H,H,H,H,H,H,H,H,H,H,H,H,H
H,1,-1,S,S,S,S,S,S,S,S,S,H,S,S,S,S,S,S,S,S,S,-1,4,H
H,-1,H,H,H,H,H,H,H,H,H,S,H,S,H,H,H,H,H,H,H,S,H,-1,H
H,S,H,S,S,S,S,S,S,H,S,S,S,S,H,S,S,S,S,S,S,S,H,S,H
H,S,H,S,H,H,H,H,S,H,H,H,H,H,H,S,H,H,H,H,S,H,H,S,H
H,S,H,S,H,S,S,S,S,S,S,S,S,S,H,S,S,H,S,H,S,S,H,S,H
H,S,H,S,H,S,H,H,H,H,H,H,H,S,H,H,H,S,H,S,H,S,H,S,H
H,S,H,S,H,S,S,S,S,S,S,S,H,H,S,S,S,S,H,S,H,S,S,S,H
H,S,H,H,H,H,H,H,H,H,H,H,S,H,H,H,H,H,H,H,H,H,S,H,H
H,S,S,S,S,S,S,S,S,S,H,S,S,S,S,S,S,S,S,S,S,S,H,S,H
H,S,H,H,H,H,H,H,H,H,H,H,H,H,H,H,H,H,H,H,H,H,H,S,H
H,S,H,S,S,S,S,S,S,S,S,S,S,S,S,S,S,S,S,S,S,S,H,S,H
H,S,H,S,H,H,H,H,H,H,H,H,H,H,H,H,H,H,H,H,S,S,H,S,H
H,S,H,S,H,S,S,S,S,S,S,S,S,S,S,S,S,S,S,H,S,H,S,S,h
H,-1,H,S,H,S,H,H,H,H,H,H,H,H,H,H,H,H,S,H,S,H,S,-1,h
H,2,-1,S,S,S,S,S,S,S,S,S,S,S,S,S,S,S,S,S,S,S,-1,3,H
H,H,H,H,H,H,H,H,H,H,H,H,H,H,H,H,H,H,H,H,H,H,H,H,H
